1111111111111
1110111011001
1100010011101
1000000000001
1000100000001
1001110011101
1E0010C0010P1
1111111111111