1111111111111
1000111001001
1000010011101
1010111000001
1110100000101
1010000000111
1E0000C00P101
1111111111111