1111111111111111
1000000000000001
1011111001111101
101C00100100C101
1010000000000101
10100M1001M00101
1011111001111101
1000000EP0000001
1011111001111101
10100M1001M00101
1010000000000101
101C00100100C101
1011111001111101
1000000000000001
1111111111111111