1111111111111111
1000000000000001
10MMMMM00MMMMM01
101C00100100C101
1010001001000101
1010001001000101
10MMMMM00MMMMM01
1000000EP0000001
10MMMMM00MMMMM01
1010001001000101
1010001001000101
101C00100100C101
10MMMMM00MMMMM01
1000000000000001
1111111111111111