1111111111111111111111
1000000M11100000001C11
100C000011100001000001
1000010000000111000001
111111000011M1C00001E1
1M00C10000C10001100111
100000000000000C1000P1
1111111111111111111111