1111111111111
1000000001C11
1000001000001
1000111000001
111M1C00001E1
1C10000000111
100000C0000P1
1111111111111